14 12 13
14 25 25
14 2 2
14 23 4
14 23 13

15 11 11
15 3 20
15 24 24
15 13 16
15 22 22



2 9 10 2


1 5 1 1
1 6 1 1
1 7 1 1
1 8 1 1 
1 9 1 1
1 5 2 1
1 6 2 1
1 7 2 1
1 8 2 1 
1 9 2 1
1 5 3 1
1 6 3 1
1 7 3 1
1 8 3 1 
1 9 3 1
1 5 4 1
1 6 4 1
1 7 4 1
1 8 4 1 
1 9 4 1

1 5 15 1
1 6 15 1
1 7 15 1
1 8 15 1 
1 9 15 1
1 5 16 1
1 6 16 1
1 7 16 1
1 8 16 1 
1 9 16 1
1 5 17 1
1 6 17 1
1 7 17 1
1 8 17 1 
1 9 17 1
1 5 18 1
1 6 18 1
1 7 18 1
1 8 18 1 
1 9 18 1
1 5 19 1
1 6 19 1
1 7 19 1
1 8 19 1 
1 9 19 1
1 5 20 1
1 6 20 1
1 7 20 1
1 8 20 1 
1 9 20 1
1 5 21 1
1 6 21 1
1 7 21 1
1 8 21 1 
1 9 21 1
1 5 22 1
1 6 22 1
1 7 22 1
1 8 22 1 
1 5 23 1
1 6 23 1
1 7 23 1
1 8 23 1 
1 5 24 1
1 6 24 1
1 7 24 1
1 8 24 1 
1 9 24 1
1 5 25 1
1 6 25 1
1 7 25 1
1 8 25 1 
1 9 25 1

1 15 5 1
1 16 5 1
1 17 5 1 
1 18 5 1 
1 19 5 1 
1 20 5 1
1 15 6 1
1 16 6 1
1 17 6 1 
1 18 6 1 
1 19 6 1 
1 20 6 1
1 15 7 1
1 16 7 1
1 17 7 1 
1 18 7 1 
1 19 7 1 
1 20 7 1
1 15 8 1
1 16 8 1
1 17 8 1 
1 18 8 1 
1 19 8 1 
1 20 8 1
1 15 9 1
1 16 9 1
1 17 9 1 
1 18 9 1 
1 19 9 1 
1 20 9 1


1 15 15 1
1 16 15 1
1 17 15 1
1 18 15 1 
1 19 15 1
1 20 15 1
1 15 16 1
1 16 16 1
1 17 16 1
1 18 16 1 
1 19 16 1
1 20 16 1
1 15 17 1
1 16 17 1
1 17 17 1
1 18 17 1 
1 19 17 1
1 15 18 1
1 16 18 1
1 17 18 1
1 18 18 1
1 19 18 1
1 15 19 1
1 16 19 1
1 17 19 1
1 18 19 1 
1 19 19 1
1 20 19 1
1 15 20 1
1 16 20 1
1 17 20 1
1 18 20 1 
1 19 20 1
1 20 20 1


0 26 1 1
0 27 1 1
0 28 1 1
0 29 1 1
0 26 2 1
0 27 2 1
0 28 2 1
0 29 2 1
0 26 3 1
0 27 3 1
0 28 3 1
0 29 3 1
0 26 4 1
0 27 4 1
0 28 4 1
0 29 4 1
0 26 5 1
0 27 5 1
0 28 5 1
0 29 5 1
0 26 6 1
0 27 6 1
0 28 6 1
0 29 6 1
0 26 7 1
0 27 7 1
0 28 7 1
0 29 7 1
0 26 8 1
0 27 8 1
0 28 8 1
0 29 8 1
0 26 9 1
0 27 9 1
0 28 9 1
0 29 9 1
0 26 10 1
0 27 10 1
0 28 10 1
0 29 10 1
0 26 11 1
0 27 11 1
0 28 11 1
0 29 11 1
0 26 12 1
0 27 12 1
0 28 12 1
0 29 12 1
0 26 13 1
0 27 13 1
0 28 13 1
0 29 13 1
0 26 14 1
0 27 14 1
0 28 14 1
0 29 14 1
0 26 15 1
0 27 15 1
0 28 15 1
0 29 15 1
0 26 16 1
0 27 16 1
0 28 16 1
0 29 16 1
0 26 17 1
0 27 17 1
0 28 17 1
0 29 17 1
0 26 18 1
0 27 18 1
0 28 18 1
0 29 18 1
0 26 19 1
0 27 19 1
0 28 19 1
0 29 19 1
0 26 20 1
0 27 20 1
0 28 20 1
0 29 20 1
0 26 21 1
0 27 21 1
0 28 21 1
0 29 21 1
0 26 22 1
0 27 22 1
0 28 22 1
0 29 22 1
0 26 23 1
0 27 23 1
0 28 23 1
0 29 23 1
0 26 24 1
0 27 24 1
0 28 24 1
0 29 24 1
0 26 25 1
0 27 25 1
0 28 25 1
0 29 25 1